R  900 600

NO ./textures/greystone.xpm
SO ./textures/eagle.xpm
EA ./textures/red.xpm
WE ./textures/purplestone.xpm
S ./textures/tonneau.xpm

C 255,255 ,255
F  0, 150, 0



111111111111111111111111111111
111111111000200000000000011111
100000000000000000111000100001
110000100000000000000000001111
100001111111000000020000111111
1111111000000000W00000000000011111111111111
1111000000000011000000020000000000000000001
1100000000000111100000000000111111111111101
100000000000111000000000000011111       101
110000000000111000000000001111001       111
110000000001111000000000000111111
111111111111111111111111111111111
