R 800 800
NO ./textures/bookshelf.xpm
SO ./textures/bricks.xpm
EA ./textures/grass.xpm
WE ./textures/stone.xpm

S ./textures/vampire.xpm
C 0, 197, 255
F 94, 75, 47


         1111111111111
1111111110000000000001111111111
1000000000000000000000000000001
1000000011111111111100000111001
1111111000000000000000000111101
1111111000000000000a00000110001
1110000000000000000000N00111111
1110000000111110000000000000001
1000000000111111111110000000001
1000000000111110000000000000001
1000000000000000000000000000001
1000000000000000002000000000001
1000000000000000001111122200001
1111111111100000001   122201111
          100000001   122201
          100000001   122201
          111111111   111101
                         101
                         101
                         101
                         111
