R 4000000 4000000
NO ./textures/bookshelf.xpm
SO ./textures/bricks.xpm
EA ./textures/grass.xpm
WE ./textures/stone.xpm

S ./textures/vampire.xpm
C 0, 0, 255
F 255, 0, 0


         111111111111
1111111110000000000001111111111
1000000000000000000000000000001
1000000011111111111100000111001
1111111000000000000000000111101
1111111000000000000000000110001
1110000000000000000000N00111111
1110000000111110000000000000001
1000000000111111111110000000001
1000000000111110000000000000001
1000000000000000000000000000001
1000000000000000002000000000001
1000000000000000001111122200001
1111111111100000001111122201111
1111111111100000001111122201111
1111111111100000001111122201111
1111111111111111111111111101111
1111111111111111111111111101111
1111111111111111111111111101111
1111111111111111111111111101111
                         111
