R 900 600

NO ../sprites/sprite_one 
SO ../sprites/sprite_two
WE ../sprites/sprite_three
EA ../sprites/sprite_four

S ../sprites/sprite_item

F 220, 100, 0
C 225, 30, 0





1111111111111111111111
10000000000000020202001
1000000000000000000111
10000000000200000001
10000000000000000001
10000000000000000001
11111111110000000001
          100000001
           1000001
            10N01
             101
              1
