R 900 600

NO ../sprites/sprite_one 
SO ../sprites/sprite_two
WE ../sprites/sprite_three
EA ../sprites/sprite_four

S ../sprites/sprite_item

F 220, 100, 0
C 225, 30, 0




1111111111111111111111111111111111111111111111111111
1000000000000000000000000000000000000000000000000001
10E0000000002000000000000000000000111111111111111101
10000000000020000000000000000000001              101
10100000000020000000000000000000001              101
10000000111000001110000011100000001              111
11000000111000001110000011100000001
10100000000000001110000000000000001111111
100000001110000001200000000000000000000021
100000011111000011100000000000000000000001
111011111111111111111111111111111100000001
  101                            11111111
   1
